11111111111111111111111111
1P0000C0000000000000000001
10111101110111111110111001
1C00000000000000C000000001
11101110111111111101111001
10000000000000000000000001
10111111101111111111011011
10000000000000000000000001
10101110111011101110111001
1C00000000000000C000000001
10111101110111111110111001
10000000000000000000000001
10111011101110111011100011
1C00000000000000C000000001
10111101110111111110111011
10000000000000000000000011
10111011101110111011100001
1C00000000000000C000000001
10111101110111111110111011
10000000000000000000000011
1E111011101110111011110001
10000000000000000000000011
11111111111111111111111111
