11111111111111111111111111111
1PCCCCCCCCCCCCCCCCCCCCCCCCCC1
1C1111C111C11111111C111CCCCC1
1CCCCCCCCCCCCCCCCCCCCCCCC1CC1
111C111C1111111111C1111CC1CC1
1CCCCCCCCCCCCCCCCCECCCCCC1CC1
1C1111111C1111111111C11C1CCC1
1CCCCCCCCCCCCCCCCCCCCCCCCCCC1
11111111111111111111111111111